o...xxx...o
.x..xxx..x.
..x..x..x..
...........
xx.......xx
xxx..s..xxx
xx.......xx
...........
..x..x..x..
.x..xxx..x.
o...xxx...o