................
.oxxxxxxxoxxxxxx
..x..x....x..x..
..x..x....x..x..
..xxxx....xxxx..
......oxxxx.....
......x...ox...o
......x....x....
o.....x....x....
......x....x....
................
xxxxxx...xxxxxxx
x..x.....x..xs..
x..x.....x..x...
xxxx.....xxxx...
................